+---+---+---+---+---+
| S |               |
+   +   +   +---+---+
|   |   |           |
+   +---+---+---+   +
|   |               |
+   +   +---+---+   +
|       |           |
+---+---+   +---+---+
|                 G 
+---+---+---+---+---+
