+---+---+---+---+---+---+---+---+
| S                             |
+   +---+---+---+---+---+---+   +
|   |                           |
+   +   +---+---+---+---+---+---+
|                               |
+---+---+   +---+   +---+   +---+
|           |       |         G 
+   +---+---+---+---+   +---+---+
|                               |
+---+---+---+---+---+---+---+---+
